30 18
300 300
0 0 0 0 0 0 0 0 0 0 0 0 0 0 0 0 0 0 0 0 0 0 0 0 0 0 0 0 0 0
0 7 7 7 7 7 7 7 7 7 7 7 7 7 7 7 7 7 7 7 7 7 7 7 7 7 7 7 7 0
0 7 6 6 6 6 6 6 6 6 6 6 6 6 6 6 6 6 6 6 6 6 6 4 6 6 6 6 7 0
0 7 6 1 2 1 1 3 4 6 4 6 2 3 4 3 2 6 2 3 4 3 2 6 2 3 4 6 7 0
0 7 6 1 1 3 3 4 6 4 6 2 3 4 3 2 2 3 4 3 2 6 2 3 4 3 2 6 7 0
0 7 6 1 3 1 3 4 6 4 6 2 3 4 3 2 6 2 3 4 3 2 0 3 4 6 2 6 7 0
0 7 6 1 1 1 2 3 4 3 2 0 3 4 6 4 6 4 6 6 6 2 3 4 3 2 7 6 7 0
0 7 6 4 2 1 2 3 4 3 2 0 3 4 6 4 6 4 6 6 0 3 4 6 2 7 7 6 7 0
0 7 6 1 1 2 0 3 4 6 4 6 4 6 6 3 4 6 4 6 6 2 3 4 3 2 7 6 7 0
0 7 6 1 1 2 0 3 4 6 4 6 4 6 6 3 4 6 4 6 0 3 4 6 2 7 7 6 7 0
0 7 6 1 1 2 0 3 4 6 4 6 4 6 6 3 4 6 4 6 2 3 4 3 2 7 7 6 7 0
0 7 6 1 1 2 0 3 4 6 4 6 4 6 6 3 4 6 4 6 6 2 3 4 3 2 7 6 7 0
0 7 6 0 0 3 4 3 2 0 3 4 6 2 3 4 3 2 6 2 3 4 3 2 7 7 7 6 7 0
0 7 6 0 1 1 2 3 4 3 2 1 3 4 6 4 6 4 6 6 3 4 3 2 0 3 4 6 7 0
0 7 6 0 1 1 2 3 4 3 2 1 3 4 6 4 6 4 6 6 0 3 4 6 2 7 7 6 7 0
0 7 6 0 1 3 4 3 2 1 3 4 6 6 2 3 4 3 2 0 3 4 6 2 7 7 7 6 7 0
0 7 6 0 0 2 3 4 3 2 6 1 1 1 2 3 4 3 0 3 4 6 2 7 7 7 7 6 7 0
0 7 6 0 0 1 2 3 4 3 2 1 3 4 6 4 6 4 6 6 2 3 4 3 2 7 7 6 7 0
